44444444444444444444444444444444444444444444444444444444444
44444444444444444444444444444444444444444444444444444444444
44443322255000000444444444000000000000000000000000000004444
44443322222550000044444440000000000000000000000000000004444
44442222225500000004444444000000000000000000000000000004444
44442222222550000000444000000000000000000000000000000004444
44442225555000000000000000000000000000000000000000000004444
44442550000000000000000000000000000000000000000000000004444
44445500000000000000000000000000000000000000000000000000000
44445000000000000000000000000000000000000000000000000004444
44445000000000000000000000000000000000000000000000000004444
44445500000000000000000000000000000000000000000000000004444
44442550000000000000000000000000000000000000000000000004444
44442255000000000000000000000000000000000000000000000004444
44442225500000000000000000000000000000000000000000000004444
44442222550000000000000000000000000000000000000000000004444
44442222255000000000000000000000000000000000000000000004444
44442222222550000000000000000000000000000000000000000004444
44444444444444444444444444444444444444444444444444444444444
44444444444444444444444444444444444444444444444444444444444
